F 255,255,255


C 10,38,78











NO ./texture/wall_n.xpm









SO ./texture/wall_s.xpm










WE ./texture/wall_w.xpm















EA ./texture/wall_e.xpm


1111111111111111
1N00001000000001
1000001111110001
1001001001010001
1011111001111111
1010001001000101
1000111110010011
1000100011111001
1000100010000001
100010001000000111111111111111
100000001000010000000010000101
100000001000000000000000000001
100000001001000000000010010001
101101111000000011011110000001
100000000000000000000000000001
111111111111111111111111111111