NO ./texture/wall_n.xpm
SO ./texture/wall_s.xpm
WE ./texture/wall_w.xpm
EA ./texture/wall_e.xpm

F 50,70,255
C 10,38,78

111111111111111111
111111111111111111
11E000010000000011
110000001111100011
110010010010100011
111111111111111111
111111111111111111

111
101
111

11111
10001
10001
11111