1111111111111
10000000C00P1
10C0011111001
10010000C0001
1001000010F01
1000111110111
1C011E00000C1
1111111111111
