11111111111111111111111
10000000C00P00000000001
10C00111110011110111111
10010000C0001C000111111
10010000100011110011111
100011111011111100000C1
1C011E00000C10000000011
11111111111111111111111
